################
#**************#
#**************#
#**************#
#**************#
#**************#
#**************#
#*************C#
################
