###################
###################
###################
###################
###################
########C##########
########*##################
########*##################
########******#############
########******#############
########******#############
########******#############
########***********########
#############******########
###########################
###########################
###########################
